1 2 1674 1676 
1 4 2083 5419 1508 1487 
1 6 1487 1246 2305 296 2124 5300 
1 8 1823 5980 1252 5923 4094 1419 4252 5709 
1 2 1823 6074 
1 7 5191 4287 4723 429 5123 5119 5116 
1 13 3690 4408 5325 737 5293 4557 1608 1023 5232 5214 5194 5184 5191 
1 7 5191 5205 3985 1718 5239 5246 4178 
1 7 3690 3386 4676 5405 3112 5455 5502 
1 2 3392 1718 
1 15 4178 2845 4003 3229 661 5316 3998 4115 8 3563 5331 1903 5302 2190 5300 
1 11 4186 5684 3234 2068 2154 4720 5539 2490 5469 5447 4781 
1 6 6660 1949 3637 228 1852 3307 
1 4 1852 1006 6672 1722 
1 4 4276 4211 310 1722 
1 2 6660 6659 
1 14 5645 532 787 3740 3321 4725 2320 3436 3120 112 6018 6052 6087 4799 
1 12 5561 1827 3340 79 5722 3526 3583 5825 3683 147 2659 5909 
1 17 4783 2183 6466 6461 4411 3267 3102 6431 639 2729 2910 1191 3084 3730 6376 1932 3850 
1 7 4692 6483 369 3430 6482 1665 4783 
1 8 3850 6305 6292 1495 991 4464 2470 3808 
1 11 3850 1279 2811 6307 697 1215 1962 6316 2253 3704 2523 
1 16 4692 1188 6459 6450 2194 4777 1951 6415 3164 4647 990 4404 2584 6346 2214 3704 
1 6 6459 517 6428 4458 6409 3084 
1 12 2523 1592 641 2070 6244 4715 3356 4841 6222 3860 4130 2470 
1 5 2032 3173 171 4869 2083 
1 7 5300 3718 1733 5245 561 5168 813 
1 4 3252 5326 1844 1487 
1 4 5502 5520 4053 5561 
1 7 3392 5274 1769 5304 745 395 4003 
1 4 3741 5382 5393 3360 
1 5 2083 2876 4030 126 296 
1 14 2032 2323 5557 3879 2418 1521 2751 5692 2263 5647 5677 1883 1986 79 
1 6 2032 2323 5510 462 4793 4522 
1 13 79 5722 2264 456 5807 2413 5887 4274 3258 5878 346 3778 4402 
1 9 79 1851 1735 848 1596 4730 871 952 5462 
1 8 395 3933 1074 3569 4100 5403 5427 5462 
1 6 952 3796 3996 937 3633 4522 
1 5 5331 244 4121 335 4522 
1 3 1591 376 1660 
1 2 1543 4055 
1 4 6672 297 6668 3524 
1 11 1280 2383 2087 3705 6498 2921 4876 2426 137 4248 3355 
1 10 4367 999 3904 6435 1280 6427 3993 1398 1243 280 
1 9 4876 2136 4039 3145 4478 6474 6465 6458 1280 
1 5 137 4014 265 6541 4747 
1 7 825 6555 4180 1349 6556 6572 6571 
1 9 10 1476 2063 2624 3525 1018 1139 2163 1134 
1 10 10 906 6548 1226 1350 4657 2948 2141 784 6556 
1 4 265 2942 6551 825 
1 7 10 4759 371 3220 6598 2318 2943 
1 4 2943 994 6622 6630 
1 8 2943 2866 6593 1601 4572 1429 326 2109 
1 5 6593 2096 3019 6561 6571 
1 2 817 2285 
1 8 6299 6290 934 6250 6262 1185 6273 3376 
1 7 6299 621 6308 4718 949 4453 2900 
1 5 6299 3750 1192 6350 2836 
1 4 6299 6278 1963 4785 
1 7 2067 2119 6000 3034 2079 3885 6061 
1 8 2079 2344 3582 445 4561 6176 2687 3133 
1 3 3582 786 6190 
1 8 6061 1397 1598 6096 6121 909 4615 778 
1 3 1598 1124 827 
1 5 6061 4220 68 1755 1213 
1 5 778 2348 2793 2873 213 
1 15 213 4668 2507 6229 1908 6257 4705 4083 1168 2962 1003 2110 3698 1402 356 
1 7 356 1920 3761 1512 6210 3422 49 
1 12 49 6186 3849 4313 3350 2818 3151 2720 1663 1754 1376 3808 
1 13 2523 3736 3077 6269 3357 2160 6223 6216 151 2530 6107 4282 6074 
1 3 641 2411 964 
1 5 91 771 6364 4590 4343 
1 5 91 761 6393 6407 6417 
1 6 91 3484 4545 6381 4208 3689 
1 5 4545 3141 6353 1269 2408 
1 2 599 18 
1 18 1213 3716 5864 2414 1013 3125 1427 3963 1306 3349 3332 2409 3976 4755 546 4637 1657 18 
1 7 599 5583 2104 1675 1702 5687 30 
1 9 30 4514 5649 2946 5631 1834 3197 4671 31 
1 9 599 5511 2202 4027 2630 1231 3710 4773 478 
1 5 478 600 3688 5180 37 
1 3 110 560 4962 
1 7 110 4669 2992 4967 3994 4957 1195 
1 5 1195 4972 1772 5008 1478 
1 5 1195 2082 3411 2099 3966 
1 2 911 2365 
1 4 911 2722 799 4917 
1 6 2365 1740 2892 4927 75 3280 
1 3 911 531 26 
1 5 26 3104 904 4911 1085 
1 7 26 3390 226 2169 3982 2579 1842 
1 3 624 12 911 
1 6 3280 3211 4938 988 3994 4957 
1 5 4962 3832 1299 4964 12 
1 3 3390 3532 624 
1 5 3686 4636 4227 3076 2259 
1 14 608 5485 5498 886 3169 4417 2189 3714 2055 4879 5609 5602 4314 4055 
1 5 608 5451 4358 4736 5393 
1 6 376 3278 2776 3140 2922 4879 
1 5 4417 513 4232 5707 969 
1 5 3714 5551 4016 1385 4023 
1 5 608 5497 672 4724 4832 
1 8 5116 4418 2970 5073 5056 4241 5014 3413 
1 7 5123 701 5088 3071 5038 4103 1682 
1 5 1682 2394 2621 234 427 
1 3 2190 5272 386 
1 6 945 1292 325 4922 1930 427 
1 5 155 5027 1091 5105 3 
1 31 813 1303 634 4503 4081 387 5240 5247 1212 3418 5234 1797 1557 1867 5202 3375 355 628 193 1386 1450 580 878 455 2739 4784 2628 5143 846 4806 3 
1 6 186 3681 1460 1329 1623 39 
1 12 186 2515 739 6302 3195 2127 1310 113 477 637 4203 2059 
1 6 2515 6268 1276 488 4029 39 
1 16 637 435 2795 482 3720 138 582 2831 6501 360 3961 6545 6562 4566 403 28 
1 10 6501 1574 6507 4138 3066 179 783 6518 2148 105 
1 17 637 1600 3423 2753 3130 3030 2483 617 2844 2893 3734 3292 936 542 3938 3060 105 
1 5 1520 2477 2953 6533 105 
1 11 1520 1449 889 503 3636 421 2856 6610 2268 4198 28 
1 11 1520 1211 6619 1496 2226 4320 1441 3361 453 4106 505 
1 5 2059 4 2045 590 122 
1 18 3 4806 3202 336 4699 304 4521 1641 3668 2864 1536 5762 131 2138 3103 436 166 122 
1 14 958 6370 6358 4591 6332 1380 3827 6343 6360 4568 2815 1399 3437 583 
1 7 958 6392 2865 1973 6433 6443 6453 
1 6 6332 3494 6329 2909 4753 6297 
1 2 3827 1053 
1 2 3437 1008 
1 4 6453 3625 1498 6440 
1 3 1380 6298 3921 
1 4 777 6537 2511 6542 
1 9 777 3127 6582 1559 6596 2685 1935 6602 40 
1 5 777 1788 3454 6535 2311 
1 4 2311 528 2407 2979 
1 5 2311 394 6525 1969 1928 
1 6 2311 526 1094 3913 3596 1431 
1 5 2311 2744 6552 967 40 
1 10 6542 2847 2589 3052 224 3576 4147 2062 1384 461 
1 4 28 1026 1658 461 
1 9 1431 358 682 2449 6420 129 2335 3419 39 
1 12 2979 974 4345 6451 867 278 3213 1260 2334 6377 3530 637 
