1 2 1674 1676 
1 4 1487 1508 5419 2083 
1 6 1487 1246 2305 296 2124 5300 
1 8 1823 5980 1252 5923 4094 1419 4252 5709 
1 2 1823 6074 
1 7 5191 4287 4723 429 5123 5119 5116 
1 13 3690 4408 5325 737 5293 4557 1608 1023 5232 5214 5194 5184 5191 
1 7 5191 5205 3985 1718 5239 5246 4178 
1 7 3690 3386 4676 5405 3112 5455 5502 
1 2 3392 1718 
1 15 4178 2845 4003 3229 661 5316 3998 4115 8 3563 5331 1903 5302 2190 5300 
1 11 4186 5684 3234 2068 2154 4720 5539 2490 5469 5447 4781 
1 6 6660 1949 3637 228 1852 3307 
1 4 1852 1006 6672 1722 
1 4 4276 4211 310 1722 
1 2 6660 6659 
1 14 5645 532 787 3740 3321 4725 2320 3436 3120 112 6018 6052 6087 4799 
1 12 5561 1827 3340 79 5722 3526 3583 5825 3683 147 2659 5909 
1 17 4783 2183 6466 6461 4411 3267 3102 6431 639 2729 2910 1191 3084 3730 6376 1932 3850 
1 7 4692 6483 369 3430 6482 1665 4783 
1 8 3850 6305 6292 1495 991 4464 2470 3808 
1 11 3850 1279 2811 6307 697 1215 1962 6316 2253 3704 2523 
1 16 4692 1188 6459 6450 2194 4777 1951 6415 3164 4647 990 4404 2584 6346 2214 3704 
1 6 6459 517 6428 4458 6409 3084 
1 12 2523 1592 641 2070 6244 4715 3356 4841 6222 3860 4130 2470 
